#################
# o        o    #
#          o  o #
#  o       oo oo#
#               #
#        ooooo  #
#            o  #
#      o     o  #
#          ooo  #
#               #
#               #
#               #
#               #
#################
