#################
#               #
#     oooo      #
#        o      #
#     o  oo     #
#        o      #
#        o      #
#        o      #
#               #
#               #
#################
