####################
#         oo oo    #
# # #o#o# #o#o# # ##
#o oo o oooo o     #
#o# # # # # #o# # ##
#   o ooo  o   o   #
# # #o# #o# #o# #o##
# o ooooooo   o   o#
# #o#o# # # #o#o# ##
# o    o    oo     #
#o# # # # #o# # # ##
#      o   oo   o  #
#o#o# #o# # #o# # ##
#o    o    ooo oo o#
# # #o# # # #o#o# ##
#  o ooo      o o  #
# # #o#o# # # #o# ##
#ooo ooo oo    o  o#
#o# # # # #o# # # ##
####################
