####################################################################################################
# o  ooo  o o  oo  o     ooo  o   o     o ooo    o o        ooo  o   ooo     o o      oo     oo   o#
# # #o# # # #o# # # # # # # # #o#o# # # # # # # #o# #o# # #o# # # #o# #o#o#o# # # # # # # # # # #o##
#o  o    o o  o    o       o  o  oo o  o  oo o  o   o  o      o     o  oo o   o    o o          o o#
#o# # # # # #o#o#o# # # # # # # #o# # # # # # # #o# #o#o# # #o#o#o# #o# # # # # # # # # #o# #o# # ##
#oo      o  o o   oo          o      o o     o    o  o o  oo   oo       o  oo   ooo o  o o     o o #
# # # #o# # # # # #o# # # # #o# #o#o# # #o# #o# #o#o# # # #o#o#o#o#o# # # # # # #o# # # #o# #o# # ##
#        ooo         o    o o    o o  o  o  o   o   o    o   oo    o  o ooo     o     oo o o ooo o #
#o# # # #o# # # # #o# # # # #o#o# # # # #o# # # # #o#o#o#o# # # # #o# #o# #o# # #o#o#o# # # #o# # ##
#  o   o o    o    o oo  o o o     o  o  o  o o    o   ooo oo o oo o o   o  o   o o  o o o o       #
# #o# #o# # # # # # #o#o#o# # # #o# # # # # #o# # # # # # # # # # # # # #o#o#o# #o# #o# # # #o#o#o##
#   o oo o o  o     o o   oo o  o  o      o  oo   oo ooo  oo o           o     o o oo      oo  o   #
#o# # # #o#o# # # # #o#o#o# #o#o# # #o# # #o# # # #o#o# # # # # # # # #o# # # # # # # # # # # # # ##
#  o  o o o       o o    o o o  o o      oo  o oo  o      o     o  o  ooo      oo  ooo oo ooo o oo #
# # #o#o# #o#o# # #o# # # # #o# #o# #o#o# # # #o# #o#o#o# # # # #o# #o# #o#o# #o# #o# #o# #o# #o#o##
#  o o o   oooo oo  oo  oo   o  oo     o o oo     ooo  o   o   o  o   oo  o    o o o   o    o      #
# # # # #o# # #o# # #o#o#o# #o# # # # #o# #o# # #o# # #o# #o# # # # # # #o#o# # # # #o# #o# # #o#o##
#        o     o o    ooo    oo o o o     oo o  o    ooo o             o  oo   o    o          o   #
# # #o# # #o# # #o# # # # # # # # # # #o# # # #o#o# # #o# # # # # #o# # # #o#o#o# #o#o# # # # # # ##
#      o oo  ooo     o o  o   o ooo     o  o             oo    o           o oo  o       o  o oooo #
#o# #o#o#o# # #o# # # #o# # # # # #o#o# # #o# # # # # # #o# #o# # # #o#o#o#o#o# # # # # #o# #o#o# ##
#o   o   oo  o     o          o  o o ooo    o o o o o      o  o o  oo       o  o oo o o o       o o#
#o#o# #o# # # #o# # #o#o# # #o#o# # # # # # # # # #o#o#o# #o#o# # #o#o# # #o#o# # # # #o# # #o# #o##
# o   o     oo   o  o          o    o o  ooo  oo    o  o   oo    o  oo  o     o  o  o oooo ooo oooo#
# #o#o#o# # # #o# #o# # #o#o# # # #o# # #o# #o# # # # #o# #o# #o# # # # #o#o# #o#o# # # # #o#o#o# ##
#     ooo    o o o      o   oo o oo  ooo      oo o o         o o   ooo o   o oo  o    o    o       #
# #o#o#o#o# # #o#o#o# # # # # # # #o#o# #o# #o# # #o# #o#o#o# # # #o# # # # # # # # #o# # # # # # ##
#   o  o o      o      o      oo  oo o                  ooo   oo  o o   o o   oo       o o   o     #
# # #o#o# # # # # # #o# # # # #o# # #o# # # # # # #o# #o#o# # # # # # #o#o# #o# # # # #o# #o# # #o##
#  o   o o oo    o o     o   o  oo  o       o  o oo     oo  o  oo     o    o  o o      oo o    o  o#
# #o# # #o# #o# # #o# #o# #o# # # #o# #o# #o# # # #o#o#o# # # # # # #o#o# #o#o# # # # # # # # # # ##
#   oo   o o   o o   oo  oo o o o     o   o oo o o    o   o   o  o     o      o  o      o oo o oo  #
# # #o# # # # #o#o#o#o# # #o# # #o#o# # #o# # #o# # #o# #o# # # # #o#o# # # # # #o#o#o# # # #o# # ##
#   oo   o    oo       o o         o  o oo  o oo   ooo oo o oo    o    o  o       o   oo  o oo   oo#
# # #o# # #o#o# # # # # # # # #o#o#o# #o# # # # # # # # # # # # #o# #o# #o# # # # #o# #o#o# # # #o##
#o      oo   o o      ooo    o o   oo     o  oo  oo o  o   oo o   oo o             oo       oo o   #
#o#o# # # #o#o# # # # # # #o# # #o# # # #o#o# #o# # # # # # #o# # # #o#o#o# # #o# #o# # # #o#o# #o##
#ooo o o o o    o o    oo   o   oo  oo   o o      o    o    ooo ooo  o  ooooo    o   o  o  o  o  o #
# # # # #o# # # # #o# # # # # # #o#o#o# # #o# # # # #o#o# # # # #o#o# # # #o# # # #o# #o# # # # #o##
#   oo oo   o o   oo o       o     o o     oooo       o ooo    oo      o  oo o  oo ooo  o o  o    o#
#o# # # # # # # #o# # #o#o# # # # # # # #o# # # #o# #o# # # #o# #o#o# # # # #o# # # #o# #o# # # #o##
# oo   o   o   o   o      o  oo     o  ooo    ooo  o   o oo       oo  oo o o       o   oo oo   o   #
# #o# #o# #o# #o# #o#o# # # #o# # # # #o# # # # # #o# # # #o#o# # #o#o#o# # # # #o#o#o# #o# #o# # ##
#    oo  oo  o    o  o   o ooo    o  o  o  o oo     o o o  o   o      o  oo      oo o     oo       #
# # #o#o# # #o#o# # # # # # # # # # #o#o# #o# # # # # # # # #o#o# #o# # # # # # # # #o# # #o# # #o##
# oo    o    o  o o o o  oo o           o    o   o o o    oo    o     o     o     oo     oo      o #
# #o#o#o# # # #o# #o# # # # # # #o#o#o# # # # # # #o# # #o#o# #o#o#o#o# # #o# # # # # #o# # # # # ##
#  oo  ooo    o  o       o  o  o       ooo    oo          ooo     o o   o    o   oo  o   o   o  o o#
#o#o#o# # #o# #o# # # # # #o# # # #o# #o# # # # #o# # #o# # # # # #o# # # # # #o# # #o# # # # # # ##
#        o  oo   o  oo            o o o    o oo o      o o      o    o    o            oo     o  o #
#o# # #o# #o#o# # #o# # # # # # #o# # # #o#o# # #o# #o# # #o# #o# # #o# # # #o#o# # # #o# # # # # ##
#   oo  o     o     o ooo         oo   oo o o    o  o      oo    oo o     oo   oo o  o  oo ooo  o o#
#o#o# # # # # # # # # # #o# # # # # #o# #o#o# # # #o#o# # #o# #o# #o# # # # # # # # # #o# # # # # ##
# o o   oo   o oo oo    oo oo  o o   o  o o  o       o    o      o               o  o  oo   ooooo  #
#o#o# #o# # # # # # # # #o# # # #o# #o# # #o#o# # #o#o#o#o# # # # # # #o# # # # #o#o# # # #o# # # ##
#  o  o ooo  oo     o  o o o        oooo   ooo      o   o  o oo  o      ooo             o    o  oo #
# # # # # # # #o# #o#o#o# #o# # # #o#o# #o#o# # #o#o# #o#o# # # # # #o# #o# #o#o# # # # #o#o#o#o# ##
#    o o  o        oooo   o o ooo   oo    ooo o       o  o  o o   o  o  ooo     o          oo   oo #
# # # #o# # # #o#o#o# # # # # # # # #o# # # #o# # #o# # # # # #o# #o# # # # # #o# #o#o# # #o# # #o##
#o  o o o   o    o   o o       o   oo  o  o o ooo   o       o         o  o     o  o       oo  oo  o#
# # #o# # # # #o# # # # #o# #o# # # #o# # # # # # # #o# #o# #o# #o# # #o#o#o# # # # # #o# #o# #o# ##
#    o    o       ooo  o   o     oo o o   o  oo   o o    o     ooo oo    o      o   o     o   ooo  #
# # # # # #o# # # # # # # #o#o# # # # #o#o# # # #o# # # #o# # #o# # # # # # # # # # # #o# #o#o#o#o##
#ooooo o        o   o    o  o  o   o     o  ooo o       oo  ooooo              oo  o o  o    oo  oo#
# # # #o#o# # #o# # #o# #o#o# # #o#o# #o# #o# #o#o# # # # # # # #o#o# # #o#o# # # # # # #o# #o# #o##
#   o  o  ooo o  o      o    o    o    o oo o     o         o  o ooo   o       o  o  o o  ooo   oo #
# # # #o# #o#o# #o#o# # #o#o# # #o# #o# # # # # #o# # # # # #o#o#o#o#o# # # # #o# # # # # #o# # #o##
#  o        oo       o o     o  ooo   o o     o  o   o   o            oo ooo oo o  oo oo   o       #
# # # # # # #o# #o#o#o# # # #o# # #o# # # # #o#o#o# #o# # #o# # #o# #o# # # #o# # #o#o# # #o# #o#o##
# o   o     o oo   o      o       oooo oo             o o  ooo      o    o o        oooo oo   o   o#
# #o# # # #o#o# #o# # # #o# # # # #o# # # #o# #o#o# #o#o#o#o# #o# # # # # # # #o# #o# # # # #o#o# ##
#   o oo oo oooo oo      ooo o  o   o   oo     oo    o  o   o    o o   oo    o  o o  o  o o   o    #
#o# #o#o# # # #o#o# # #o# #o# # # #o# #o# # # # # # #o#o# # #o# # #o#o# #o#o# # # # #o# # # # # #o##
#oo   ooooo  ooo o   o         o oo oo o o oo  o o        o    o o   o  o     o o  oo    o   oo  oo#
#o# # #o# # #o# # # # # #o# # # # #o#o#o# # #o# # #o# # #o#o#o# # # # # #o#o# # # # # # # # # # # ##
#  oo o o o oo oo  oo   o     o  o    o     o   o o  o  o   ooooo   o    ooo   o o   o oo      oo  #
#o# # # #o#o#o# #o# # # #o# #o# #o# #o# #o# #o# # #o# # # # #o# # # #o# # #o# # # # # # # #o# #o#o##
# o   o  oo   oo           oo   oo  oo o       oo  ooo   oo    o oo ooo  ooo o  ooo o      o o o oo#
#o# # # # # # # # # # # #o# # #o# #o#o# # #o#o# # #o# # # #o# # # # #o# # # # # #o# # # #o# # # # ##
#     ooo  oo    o o o oo            oo   o o     oo     ooo oo   oo oo o oo    o  oo  o    o      #
# # #o# #o# #o# # # # #o# # # # # #o# #o#o# #o# #o# # #o# #o#o# # # #o# # # # #o# #o#o#o# #o# # # ##
#oo   o o o   ooooo        o       o  oo ooo oo  o    ooo ooo oo  o  o     o      ooo o       oo   #
# # # #o#o# #o# # # # #o#o# # # #o# #o#o# # # #o# # #o# #o# # # # # # #o# # # # # # # # #o# # #o# ##
# ooo o  o  ooo     oo   o ooo ooo o              o o     o o o           o     oooo   o oo o  oo o#
# #o#o# # # #o# # # # #o#o# #o# # # # # #o# # #o# #o# #o#o#o# # # # # # # # # # # # #o# #o# # # # ##
#oo o     ooo    o    ooo     o o      o ooo   oooo  o    o  o      o  o o  o o  oo  o o o  o    o #
# # # #o# # #o#o#o# # #o# # # # # # # #o#o# #o# #o# #o# # #o# # # #o# # # # # # # # # # # # # # #o##
#o o   o  o  o  o oo  o o     ooo o     o      oo     o oo  o o      o    oo  oo   o o ooo  o o    #
#o# # # # # # # #o# # # # # # # # #o# #o# #o# #o#o# #o# #o# # # #o# # # # #o#o#o# # # # # # # #o# ##
#o   o oo        o o o oo o   oo oo oo   o    oo   oo        oo oo    o      o  o  oooooo ooo      #
# #o#o#o# # # # # # # # # # #o# # # # # # # #o# # #o# # # # # # # # # #o#o# #o#o# # #o# # # # # # ##
#  o  o  oo  o   oo    o    o  o       o         oo   o  oo o   o  o   o o   ooo  o            o   #
#o# # # # # #o#o#o# # # #o#o# # # # #o#o# #o# #o# #o# # # # #o#o# # #o# #o# # # # # # # #o# # # #o##
#o    o  oo      o oo o   ooooo  o   o  oo o o  oo     o     o  o o  o   o o oo  o ooo oooo o o    #
# # # # # # # # #o#o# # #o#o# # #o#o# # # #o# # # #o# # #o# #o#o# #o#o# # # # # # # # # #o# # #o# ##
# o    o    o    o o      oo  oo o o o          o o  o       o o        o  oo  o oo        ooo oo  #
# #o#o#o# # # #o# #o# #o#o# #o#o# # # # # #o#o# #o# #o# # #o# # # # #o# #o#o# #o# # #o#o# #o# #o#o##
#oo oo        o  ooooo    o    o ooooo      o o   o o  o   o  o oo   o oo ooo o       oo  o oo o   #
# # #o#o#o# #o# # # #o#o# # # # #o# # # # # # #o# # # # # # #o# # #o# # # # # #o#o# # # # # #o# # ##
####################################################################################################
