#########################
#oo oo  oooo o     ooooo#
# # #o#o#o# #o# #o# #o# #
#  o  oo o  o o     ooo #
# # # # #o#o#o# # # # #o#
#o     o     oo  o o ooo#
#o# # # #o# # #o#o#o#o# #
#  ooo        ooo  o  oo#
#o# # # #o#o#o# # #o# #o#
#    o   o  o     o o  o#
#o# # #o# # #o#o#o# #o# #
#  ooooo o  oo    o   oo#
#o# #o#o#o#o# #o# # # # #
# o    o  o  o ooo   o  #
#o#o# # # #o# # # # # #o#
# o  o o   o    oo ooo o#
#o# # # # # # #o# # # # #
#  oo    o    o o       #
#o# # #o# #o# # # #o#o#o#
#          oo  o o o oo #
# # # # #o# # # #o#o# # #
#  ooo  o      o  o oo  #
# #o# # # # #o# # # # # #
#oo o   o  o o  oo  oo o#
#########################
