##############################
#   oo     o     o    oo  o o#
# # #o# # # # #o#o# # #o#o# ##
#o o ooo   oo  o   oo ooo    #
#o# #o# #o# #o# #o#o# # # # ##
#                 o         o#
# # # # #o# # # #o# # #o#o#o##
#    o    o o   o    o     oo#
#o# #o#o# # # #o#o# # # # # ##
#  o   ooo         oo o  o   #
# # # #o# # # # # #o#o# # # ##
#  o   o  o   ooo     o     o#
#o# # #o# # #o# # #o# #o# # ##
#    ooo  o o       o   o    #
#o#o# # #o#o# #o# # #o# #o#o##
# oo oo o    ooo     o o  o o#
# # #o# # #o# #o# # #o# # # ##
#     ooo    o   oo o  oo o  #
#o# # # #o#o#o# #o# #o# # # ##
#ooo o       ooooo o      o  #
# # # #o# # # # # # #o#o# #o##
#     o    o         o  o   o#
#o# # # # # # # #o# # # # # ##
# oooo ooo  o      oo oo   oo#
# #o# # # #o# # # # # #o# #o##
#      o     o   o   o      o#
#o# # # #o# # # # # # # # #o##
#o  oo         o oo o    o o #
# # # #o#o#o# # # # # # # # ##
##############################
