##################################################
#  oo o o o  o oo o  oo o      oo    ooo  oo  oo #
#o# # # # # #o#o#o#o#o# #o# #o# # #o# # #o# # #o##
#ooo    o   ooo   oo             o o oo    ooo o #
# #o# # # #o#o# #o#o#o# #o# #o#o# # # #o#o# # #o##
# o    ooo o o o oo    o o     o     oo o  o   o #
#o#o# # #o#o# # # # # # #o#o# # # # #o# # #o#o# ##
#       o         oo o o      oo      o  ooo   o #
# # # # #o#o#o# # # #o# # #o# # # # #o#o# # # #o##
#oo    o  o   ooo    o     o      o   o      o o #
# # # #o#o#o#o# # #o# #o# # #o# #o# # # # #o# # ##
#o o o     oo  o ooo o          o       o     o  #
# # # # # # #o#o# # #o# #o# #o# # # #o#o#o#o#o# ##
# o  o   o  o o o   o     o o oo oo  o           #
# # # # #o# # #o# # # # # #o# # # # # #o#o# # # ##
# o        oo    o    oo  oo   oo   o    o    o o#
# # # # # # # # #o# #o# #o# #o# #o# # # # # #o#o##
#   o    o   o  oo  oo  oo o          oo ooo    o#
# # # #o# # # # #o# # #o#o# # # # # # #o# #o# #o##
#  o   o     oo ooo   oo  o    oo oo    o   oo o #
# # # #o# # #o# #o# # # #o# # # # # # # # # # # ##
#oo oo o  o o o  o  o o o     oo o     oooo  o  o#
# # #o#o# # #o# # # # # # #o#o# # #o#o# #o# # #o##
#        oo     oo   o     o  o                o #
# # # # # #o# # # #o# # #o#o#o# # # # # # # # # ##
#oo     o ooo o     oo      oo   o  o      oooo o#
# # # #o#o#o#o# # # #o# # # # # # #o#o#o#o# # #o##
#  o           oo  oo     o oo   ooo oo    o     #
#o# # #o#o#o#o# # # # #o# # # # #o#o#o#o# # #o# ##
# o   o  o     o o        o    oooo o  o  o  o  o#
# #o# #o# #o# # # # # #o#o# #o#o# # # # #o#o#o#o##
# o  o     o      oo  oo  o   o  o   ooo  o  o   #
# #o# #o# # #o# #o# #o#o# # # # #o#o# # # #o# # ##
#   ooo       o o  o  ooo   o o o     oo   o  o  #
# # # # #o# # #o# # # #o#o# # # # #o# # #o#o# # ##
#oo    o          o  o  oo  o    o   o o o  o ooo#
#o#o# # # #o#o# # # #o# #o# # # # #o# #o# # # # ##
#    o      o      oo      o   o ooo      oo o o #
# #o# # # # #o# # #o# # # # # #o#o# # # #o# # # ##
#o o  o o ooo              oo  o o ooo oo   o    #
# # # # # # # #o# # # # # # #o# # #o# #o# #o# # ##
#oo o      o   oo o    oo ooooo o o   o o o   o  #
# #o# # #o# #o# #o#o#o# #o# # #o# # #o# # # # # ##
#         o  o   o     oo   oooo  oo   o  o      #
# # # # # #o#o#o#o#o#o# # #o#o#o# #o# #o# # # # ##
#    o ooo ooo    ooo    oo      ooo  o  o      o#
# #o#o#o# #o# # #o# # # # # # # # # # #o#o#o# # ##
#oo   o o o     o o  o o     o    o    o  oo     #
#o# # # # # #o# #o#o# # #o#o# # # #o# #o# # # #o##
##################################################
