#####
#o o#
# # #
#o  #
#####
