##########
#   o o  #
# # # #o##
#  oo o  #
# # # # ##
#   oo o #
# # # #o##
#oo  o  o#
# # # # ##
##########
