########################################
#    o  o  o o o o oooo o    oo   o o o#
#o# # # # # # #o# # # # #o#o# #o#o# # ##
#  ooooo  o  ooo o   o   oo    o     o #
#o# # # #o# # #o# #o# # #o# #o# #o# #o##
#o    oo oo o       oo   oo o          #
# # # #o# # #o# # #o#o#o# #o# #o#o# # ##
#  o oo o o ooo     o  o o   o     o o #
# # #o# # # # # # # # # # # # #o#o# # ##
#  o   o     oo   o     o       oo   oo#
# # # # #o# # #o#o#o# # # #o# #o# #o# ##
#  o    oo    ooo   o o o   oo    o ooo#
# # #o# # #o#o# # # #o# # # # #o# # #o##
#ooo           o     oo oo   oo     o  #
#o# #o# #o# # #o#o# #o#o# #o# # # #o# ##
#o             o   ooo     oo    ooo  o#
# # # # # #o# # # # # #o#o# #o# # # #o##
#  o  o oo ooo  oo         o o o   o   #
#o# # # #o#o# # # #o# # # # # # # # # ##
#    o o o   o               o    oo o #
#o# #o# # # # # # # # #o# # # # # #o# ##
#                o       o  oo      o  #
# # # # #o# # #o# # # #o#o#o# #o# #o#o##
#   o o   oo oo o  o       o o  oo    o#
# # # # # #o# # # # # # # # # # #o# #o##
# o o     o ooo o  o oo  o   oo  ooo   #
# # #o#o#o#o# # # # # # #o# #o# # #o# ##
# oo  o      o   oo       ooo  oo oo o #
#o#o# # # #o#o# #o# # # # #o#o# # # # ##
#          o o   o      oo  o oo       #
# # # # #o# # # # # # # # #o# # # #o#o##
#o   o oo    o  o     o    oo       o  #
# #o# # # #o# #o# # #o#o# # # #o#o# # ##
#      oo  o      o           ooo      #
# #o#o#o# # # #o#o# # # #o# #o#o#o# #o##
#    o oo   oo  o  o   o o  o   o  oo o#
#o# #o# # #o# # #o# # # # # # #o# # #o##
#    oooo        oo    oo oo   o      o#
# # #o# #o#o#o# # #o#o# # # # #o# # # ##
########################################
